//MAP CONVERTED BY dmm2tgm.py THIS HEADER COMMENT PREVENTS RECONVERSION, DO NOT REMOVE
"a" = (
/turf/template_noop,
/area/template_noop)
"b" = (
/obj/structure/flora/bush,
/turf/template_noop,
/area/template_noop)
"d" = (
/obj/structure/flora/ausbushes/lavendergrass,
/turf/template_noop,
/area/template_noop)
"e" = (
/obj/structure/flora/grass/green,
/turf/template_noop,
/area/template_noop)
"f" = (
/obj/structure/flora/grass/both,
/turf/template_noop,
/area/template_noop)
"g" = (
/obj/landmark/clear,
/obj/landmark/clear,
/turf/template_noop,
/area/template_noop)
"h" = (
/obj/structure/flora/ausbushes/reedbush,
/turf/template_noop,
/area/template_noop)
"i" = (
/obj/landmark/clear,
/obj/landmark/clear,
/obj/landmark/clear,
/turf/template_noop,
/area/template_noop)
"j" = (
/obj/landmark/clear,
/turf/template_noop,
/area/template_noop)
"k" = (
/obj/structure/flora/ausbushes/palebush,
/turf/template_noop,
/area/template_noop)
"l" = (
/obj/structure/flora/grass/brown,
/turf/template_noop,
/area/template_noop)
"m" = (
/obj/structure/flora/ausbushes,
/turf/template_noop,
/area/template_noop)

(1,1,1) = {"
a
a
a
a
a
a
a
a
a
a
a
a
a
a
a
a
a
a
a
a
"}
(2,1,1) = {"
a
j
j
j
j
j
j
j
j
j
j
j
j
j
j
j
d
j
j
a
"}
(3,1,1) = {"
a
j
j
j
j
j
j
j
j
j
j
j
j
j
b
j
f
j
j
a
"}
(4,1,1) = {"
a
j
j
j
j
j
j
j
j
j
j
j
j
j
j
f
j
e
j
a
"}
(5,1,1) = {"
a
j
j
j
j
j
j
j
j
j
j
j
j
j
d
e
g
j
k
a
"}
(6,1,1) = {"
a
j
j
j
j
j
j
j
j
j
j
j
j
j
e
j
i
g
j
a
"}
(7,1,1) = {"
a
j
j
j
j
j
j
j
j
j
j
j
j
j
j
e
g
j
l
a
"}
(8,1,1) = {"
a
j
j
j
j
j
j
j
j
j
j
j
j
j
e
h
g
j
l
a
"}
(9,1,1) = {"
a
j
j
j
j
j
j
j
j
j
j
j
j
j
j
e
j
j
b
a
"}
(10,1,1) = {"
a
j
j
j
j
j
j
j
j
j
j
j
j
j
g
j
f
h
j
a
"}
(11,1,1) = {"
a
j
j
j
j
j
j
j
j
j
j
j
j
j
j
j
b
j
m
a
"}
(12,1,1) = {"
a
j
j
j
j
j
j
j
j
j
j
j
j
j
j
j
j
j
j
a
"}
(13,1,1) = {"
a
j
j
j
j
j
j
j
j
j
j
j
j
j
j
j
j
j
j
a
"}
(14,1,1) = {"
a
a
a
a
a
a
a
a
a
a
a
a
a
a
a
a
a
a
a
a
"}
