//MAP CONVERTED BY dmm2tgm.py THIS HEADER COMMENT PREVENTS RECONVERSION, DO NOT REMOVE
"a" = (
/turf/template_noop,
/area/template_noop)
"b" = (
/obj/structure/barricade/barbed,
/obj/decal/remains,
/turf/template_noop,
/area/template_noop)
"c" = (
/obj/decal/cleanable/blood,
/turf/simulated/floor/warhammer/surface_floor,
/area/template_noop)
"d" = (
/obj/structure/barricade/sandbag{
	dir = 8
	},
/obj/item/clothing/gloves/thick/swat/cadian,
/turf/simulated/floor/warhammer/surface_floor,
/area/template_noop)
"e" = (
/obj/structure/rubble,
/turf/simulated/floor/warhammer/brick,
/area/template_noop)
"f" = (
/turf/simulated/floor/warhammer/brick,
/area/template_noop)
"h" = (
/obj/structure/barricade/sandbag,
/obj/structure/barricade/sandbag{
	dir = 8
	},
/turf/simulated/floor/warhammer/brick,
/area/template_noop)
"i" = (
/obj/decal/remains,
/turf/template_noop,
/area/template_noop)
"j" = (
/obj/structure/hivedecor/gun_rack,
/obj/item/gun/energy/lasgun/kantrael,
/turf/simulated/floor/warhammer/brick,
/area/template_noop)
"k" = (
/obj/item/campfire,
/turf/simulated/floor/warhammer/surface_floor,
/area/template_noop)
"l" = (
/obj/decal/cleanable/blood/splatter,
/obj/item/clothing/head/helmet/guardcap/sergeant{
	was_bloodied = 1
	},
/turf/simulated/floor/warhammer/brick,
/area/template_noop)
"m" = (
/obj/structure/barricade/sandbag{
	dir = 4
	},
/turf/simulated/floor/warhammer/surface_floor,
/area/template_noop)
"o" = (
/obj/structure/rubble,
/turf/template_noop,
/area/template_noop)
"p" = (
/obj/gibspawner/human,
/turf/template_noop,
/area/template_noop)
"q" = (
/turf/simulated/floor/warhammer/surface_floor,
/area/template_noop)
"s" = (
/obj/random/loot/randomsupply,
/obj/item/clothing/shoes/jackboots/cadian,
/turf/simulated/floor/warhammer/brick,
/area/template_noop)
"u" = (
/obj/structure/statue/guardshrine{
	name = "\improper Shrine of the Emperor's Mercy";
	desc = "The Fallen shall forever be rememberd as the Emperor's Finest!"
	},
/turf/simulated/floor/warhammer/brick,
/area/template_noop)
"v" = (
/obj/structure/barricade/sandbag{
	dir = 4
	},
/turf/template_noop,
/area/template_noop)
"w" = (
/obj/decal/remains,
/obj/decal/cleanable/blood,
/turf/simulated/floor/warhammer/brick,
/area/template_noop)
"x" = (
/obj/structure/barricade/sandbag,
/turf/simulated/floor/warhammer/brick,
/area/template_noop)
"y" = (
/obj/effect/floor_decal/newcorner/crater_small,
/obj/gibspawner/human,
/obj/item/clothing/mask/gas/half/cadianrespirator,
/turf/simulated/floor/warhammer/surface_floor,
/area/template_noop)
"z" = (
/obj/effect/floor_decal/newcorner/crater_small,
/obj/item/clothing/under/cadian_uniform,
/turf/simulated/floor/warhammer/brick,
/area/template_noop)
"A" = (
/obj/structure/rubble,
/turf/simulated/floor/warhammer/surface_floor,
/area/template_noop)
"B" = (
/obj/structure/barricade/sandbag{
	dir = 4
	},
/obj/structure/hivedecor/floodlight,
/turf/simulated/floor/warhammer/surface_floor,
/area/template_noop)
"C" = (
/obj/item/clothing/head/helmet/flak,
/turf/simulated/floor/warhammer/brick,
/area/template_noop)
"D" = (
/obj/structure/hivedecor/gun_rack,
/obj/random/loot/lasbundle,
/turf/simulated/floor/warhammer/brick,
/area/template_noop)
"E" = (
/obj/structure/barricade/sandbag{
	dir = 16
	},
/turf/simulated/floor/warhammer/brick,
/area/template_noop)
"F" = (
/obj/random/loot/lightmelee,
/turf/simulated/floor/warhammer/brick,
/area/template_noop)
"G" = (
/obj/decal/cleanable/blood/splatter,
/turf/simulated/floor/warhammer/surface_floor,
/area/template_noop)
"H" = (
/obj/structure/hivedecor/artillery,
/turf/simulated/floor/warhammer/surface_floor,
/area/template_noop)
"I" = (
/obj/random/loot/randomsupply/engineering,
/turf/simulated/floor/warhammer/brick,
/area/template_noop)
"J" = (
/obj/structure/hivedecor/chimera_wreck,
/turf/template_noop,
/area/template_noop)
"K" = (
/obj/structure/barricade/barbed,
/turf/template_noop,
/area/template_noop)
"L" = (
/obj/decal/remains,
/turf/simulated/floor/warhammer/brick,
/area/template_noop)
"M" = (
/obj/decal/cleanable/blood,
/turf/template_noop,
/area/template_noop)
"N" = (
/obj/effect/floor_decal/newcorner/crater_small,
/obj/gibspawner/human,
/turf/template_noop,
/area/template_noop)
"O" = (
/obj/decal/cleanable/spiderling_remains,
/turf/template_noop,
/area/template_noop)
"P" = (
/obj/decal/cleanable/blood/drip,
/turf/simulated/floor/warhammer/surface_floor,
/area/template_noop)
"R" = (
/obj/effect/floor_decal/newcorner/crater_small,
/turf/template_noop,
/area/template_noop)
"U" = (
/mob/living/simple_animal/hostile/human/heretic/trooper,
/turf/simulated/floor/warhammer/brick,
/area/template_noop)
"W" = (
/obj/structure/barricade/sandbag{
	dir = 8
	},
/turf/simulated/floor/warhammer/brick,
/area/template_noop)
"X" = (
/obj/structure/barricade/sandbag{
	dir = 1
	},
/turf/simulated/floor/warhammer/surface_floor,
/area/template_noop)
"Y" = (
/obj/structure/barricade/sandbag{
	dir = 1
	},
/obj/structure/barricade/sandbag{
	dir = 4
	},
/turf/simulated/floor/warhammer/brick,
/area/template_noop)
"Z" = (
/obj/item/exploration_loot/guard_diary,
/turf/simulated/floor/warhammer/brick,
/area/template_noop)

(1,1,1) = {"
K
K
a
a
o
a
q
a
K
a
a
a
"}
(2,1,1) = {"
K
a
q
d
f
I
q
W
h
K
q
a
"}
(3,1,1) = {"
a
a
N
q
k
f
f
w
x
L
a
q
"}
(4,1,1) = {"
q
q
Y
Z
f
l
U
q
q
a
R
M
"}
(5,1,1) = {"
a
q
f
L
q
f
z
f
q
q
J
P
"}
(6,1,1) = {"
a
A
j
f
q
u
q
F
f
f
p
A
"}
(7,1,1) = {"
a
f
f
q
f
f
f
f
f
f
q
O
"}
(8,1,1) = {"
R
X
D
G
f
f
C
f
H
E
K
a
"}
(9,1,1) = {"
a
X
f
q
y
f
f
e
q
E
b
a
"}
(10,1,1) = {"
K
K
q
f
f
L
s
f
q
q
a
a
"}
(11,1,1) = {"
q
a
q
c
v
m
q
B
K
q
c
a
"}
(12,1,1) = {"
A
q
a
a
a
a
q
q
a
K
a
i
"}
