//MAP CONVERTED BY dmm2tgm.py THIS HEADER COMMENT PREVENTS RECONVERSION, DO NOT REMOVE
"aa" = (
/turf/space/bluespace,
/area/space)
"ab" = (
/turf/unsimulated/wall,
/area/map_template/wizard_station)
"ac" = (
/turf/unsimulated/wall/fakeglass{
	dir = 8
	},
/area/map_template/wizard_station)
"ad" = (
/turf/unsimulated/wall/fakeglass{
	dir = 8;
	icon_state = "fakewindows2"
	},
/area/map_template/wizard_station)
"ae" = (
/turf/unsimulated/wall/fakeglass{
	dir = 4
	},
/area/map_template/wizard_station)
"af" = (
/obj/structure/table/woodentable,
/obj/item/device/flashlight/lamp/green{
	on = 0;
	pixel_x = -3;
	pixel_y = 8
	},
/obj/item/reagent_containers/food/drinks/flask/barflask,
/turf/simulated/floor/warhammer/darkwood,
/area/map_template/wizard_station)
"ag" = (
/obj/structure/bed/padded,
/obj/item/bedsheet/rd,
/turf/simulated/floor/warhammer/darkwood,
/area/map_template/wizard_station)
"ah" = (
/obj/structure/table/woodentable,
/obj/item/storage/backpack/satchel/grey/withwallet,
/obj/item/clothing/glasses/monocle,
/turf/simulated/floor/warhammer/darkwood,
/area/map_template/wizard_station)
"ai" = (
/obj/structure/table/woodentable,
/obj/landmark{
	name = "Teleport-Scroll"
	},
/obj/item/toy/figure/ninja,
/turf/simulated/floor/warhammer/darkwood,
/area/map_template/wizard_station)
"aj" = (
/obj/landmark/start{
	name = "wizard"
	},
/turf/simulated/floor/warhammer/darkwood,
/area/map_template/wizard_station)
"ak" = (
/obj/structure/aliumizer,
/turf/simulated/floor/warhammer/darkwood,
/area/map_template/wizard_station)
"al" = (
/obj/structure/table/woodentable,
/obj/item/storage/backpack/cultpack,
/turf/simulated/floor/warhammer/darkwood,
/area/map_template/wizard_station)
"am" = (
/turf/simulated/floor/warhammer/darkwood,
/area/map_template/wizard_station)
"an" = (
/obj/item/device/radio/intercom/syndicate{
	dir = 8;
	pixel_x = 22
	},
/turf/simulated/floor/warhammer/darkwood,
/area/map_template/wizard_station)
"ao" = (
/obj/structure/table/woodentable,
/obj/item/storage/backpack/satchel/grey/withwallet,
/turf/simulated/floor/warhammer/darkwood,
/area/map_template/wizard_station)
"ap" = (
/obj/structure/undies_wardrobe,
/turf/simulated/floor/warhammer/darkwood,
/area/map_template/wizard_station)
"aq" = (
/obj/machinery/door/unpowered/simple/wood,
/turf/simulated/floor/warhammer/darkwood,
/area/map_template/wizard_station)
"ar" = (
/obj/structure/bookcase{
	name = "Forbidden Knowledge"
	},
/obj/decal/cleanable/cobweb,
/turf/simulated/floor/warhammer/darkwood,
/area/map_template/wizard_station)
"as" = (
/obj/structure/table/woodentable,
/obj/item/dice,
/obj/item/material/twohanded/ravenor/sword/demon,
/turf/simulated/floor/warhammer/darkwood,
/area/map_template/wizard_station)
"au" = (
/obj/structure/table/woodentable,
/obj/item/dice/d20,
/obj/item/material/twohanded/ravenor/axe/thunderhammer,
/turf/simulated/floor/warhammer/darkwood,
/area/map_template/wizard_station)
"av" = (
/obj/structure/bookcase{
	name = "bookcase (Tactics)"
	},
/turf/simulated/floor/warhammer/darkwood,
/area/map_template/wizard_station)
"aw" = (
/obj/structure/bookcase{
	name = "Forbidden Knowledge"
	},
/turf/simulated/floor/warhammer/darkwood,
/area/map_template/wizard_station)
"ax" = (
/mob/living/carbon/human/monkey{
	name = "Murphey"
	},
/turf/simulated/floor/warhammer/darkwood,
/area/map_template/wizard_station)
"ay" = (
/turf/unsimulated/wall/fakeglass{
	dir = 1
	},
/area/map_template/wizard_station)
"aA" = (
/obj/item/bikehorn/rubberducky,
/turf/simulated/floor/warhammer/darkwood,
/area/map_template/wizard_station)
"aB" = (
/obj/floor_decal/spline/fancy/wood{
	dir = 8
	},
/obj/machinery/acting/changer/mirror{
	pixel_y = 32
	},
/turf/simulated/floor/warhammer/darkwood,
/area/map_template/wizard_station)
"aC" = (
/obj/structure/hygiene/toilet{
	pixel_y = 8
	},
/turf/simulated/floor/warhammer/darkwood,
/area/map_template/wizard_station)
"aD" = (
/obj/structure/table/woodentable,
/obj/machinery/computer/modular/preset/library,
/obj/item/device/radio/intercom/syndicate{
	dir = 4;
	pixel_x = -22
	},
/turf/simulated/floor/warhammer/darkwood,
/area/map_template/wizard_station)
"aE" = (
/obj/structure/bed/chair/wood/wings{
	dir = 4;
	icon_state = "wooden_chair_wings"
	},
/turf/simulated/floor/warhammer/darkwood,
/area/map_template/wizard_station)
"aF" = (
/obj/structure/table/woodentable,
/obj/item/reagent_containers/food/snacks/chawanmushi,
/obj/random/loot/lootartifacts,
/turf/simulated/floor/warhammer/darkwood,
/area/map_template/wizard_station)
"aG" = (
/obj/structure/bed/chair/wood/wings{
	dir = 8;
	icon_state = "wooden_chair_wings"
	},
/turf/simulated/floor/warhammer/darkwood,
/area/map_template/wizard_station)
"aH" = (
/obj/structure/table/woodentable,
/obj/item/storage/box/cups,
/turf/simulated/floor/warhammer/darkwood,
/area/map_template/wizard_station)
"aI" = (
/obj/structure/closet,
/obj/item/clothing/suit/wizrobe/red,
/obj/item/clothing/shoes/sandal,
/obj/item/clothing/head/wizard/red,
/obj/item/staff,
/turf/simulated/floor/warhammer/darkwood,
/area/map_template/wizard_station)
"aJ" = (
/obj/structure/closet,
/obj/item/clothing/suit/wizrobe/marisa,
/obj/item/clothing/shoes/sandal/marisa,
/obj/item/clothing/head/wizard/marisa,
/obj/item/staff/broom,
/turf/simulated/floor/warhammer/darkwood,
/area/map_template/wizard_station)
"aK" = (
/obj/structure/closet,
/obj/item/clothing/suit/wizrobe/magusblue,
/obj/item/clothing/head/wizard/magus,
/obj/item/staff,
/turf/simulated/floor/warhammer/darkwood,
/area/map_template/wizard_station)
"aL" = (
/obj/structure/closet,
/obj/item/reagent_containers/food/drinks/bottle/bottleofnothing,
/obj/item/reagent_containers/food/drinks/bottle/pwine,
/obj/item/reagent_containers/food/drinks/bottle/specialwhiskey,
/obj/item/reagent_containers/food/drinks/bottle/cognac,
/turf/simulated/floor/warhammer/darkwood,
/area/map_template/wizard_station)
"aM" = (
/turf/unsimulated/wall/fakeglass{
	dir = 1;
	icon_state = "fakewindows2"
	},
/area/map_template/wizard_station)
"aN" = (
/obj/floor_decal/spline/fancy/wood{
	dir = 8
	},
/turf/simulated/floor/warhammer/darkwood,
/area/map_template/wizard_station)
"aP" = (
/obj/machinery/door/unpowered/simple/iron,
/turf/simulated/floor/warhammer/darkwood,
/area/map_template/wizard_station)
"aQ" = (
/obj/structure/table/woodentable,
/obj/item/device/megaphone,
/obj/random/loot/lootcontraband,
/turf/simulated/floor/warhammer/darkwood,
/area/map_template/wizard_station)
"aR" = (
/obj/structure/table/woodentable,
/obj/item/storage/box/donut,
/turf/simulated/floor/warhammer/darkwood,
/area/map_template/wizard_station)
"aS" = (
/obj/structure/table/woodentable,
/obj/item/spacecash/bundle/c1,
/obj/random/loot/lootcontraband,
/turf/simulated/floor/warhammer/darkwood,
/area/map_template/wizard_station)
"aV" = (
/turf/unsimulated/wall/fakeglass,
/area/map_template/wizard_station)
"aW" = (
/obj/item/soap,
/turf/simulated/floor/warhammer/darkwood,
/area/map_template/wizard_station)
"aX" = (
/obj/floor_decal/spline/fancy/wood{
	dir = 8
	},
/obj/item/device/radio/intercom/syndicate{
	dir = 1;
	pixel_y = -22
	},
/turf/simulated/floor/warhammer/darkwood,
/area/map_template/wizard_station)
"aY" = (
/obj/structure/hygiene/sink{
	dir = 4;
	pixel_x = 11
	},
/obj/item/storage/mirror{
	pixel_x = 32
	},
/turf/simulated/floor/warhammer/darkwood,
/area/map_template/wizard_station)
"aZ" = (
/obj/machinery/vending/magivend,
/turf/simulated/floor/warhammer/darkwood,
/area/map_template/wizard_station)
"ba" = (
/obj/structure/table/woodentable,
/obj/item/reagent_containers/food/snacks/milosoup,
/obj/random/loot/lootartifacts,
/turf/simulated/floor/warhammer/darkwood,
/area/map_template/wizard_station)
"bb" = (
/obj/structure/table/woodentable,
/obj/machinery/chemical_dispenser/bar_soft/full,
/obj/item/device/radio/intercom/syndicate{
	dir = 8;
	pixel_x = 22
	},
/turf/simulated/floor/warhammer/darkwood,
/area/map_template/wizard_station)
"bc" = (
/obj/structure/closet,
/obj/item/clothing/under/psysuit,
/obj/item/clothing/suit/wizrobe/psypurple,
/turf/simulated/floor/warhammer/darkwood,
/area/map_template/wizard_station)
"bd" = (
/obj/structure/closet,
/obj/item/clothing/shoes/sandal/marisa{
	desc = "A set of fancy shoes that are as functional as they are comfortable.";
	name = "Gentlemans Shoes"
	},
/obj/item/clothing/under/gentlesuit,
/obj/item/clothing/suit/wizrobe/gentlecoat,
/obj/item/clothing/head/wizard/cap,
/obj/item/staff/gentcane,
/obj/item/device/radio/intercom/syndicate{
	dir = 1;
	pixel_y = -22
	},
/turf/simulated/floor/warhammer/darkwood,
/area/map_template/wizard_station)
"be" = (
/obj/structure/closet,
/obj/item/clothing/suit/wizrobe/magusred,
/obj/item/clothing/head/wizard/magus,
/obj/item/staff,
/turf/simulated/floor/warhammer/darkwood,
/area/map_template/wizard_station)
"bf" = (
/obj/structure/closet,
/obj/item/storage/briefcase,
/turf/simulated/floor/warhammer/darkwood,
/area/map_template/wizard_station)
"bg" = (
/obj/structure/bookcase,
/obj/item/book/manual/nuclear,
/turf/simulated/floor/warhammer/darkwood,
/area/map_template/wizard_station)
"bh" = (
/obj/structure/bookcase,
/obj/item/book/manual/robotics_cyborgs,
/turf/simulated/floor/warhammer/darkwood,
/area/map_template/wizard_station)
"bi" = (
/obj/structure/bookcase,
/turf/simulated/floor/warhammer/darkwood,
/area/map_template/wizard_station)
"bj" = (
/obj/structure/table/woodentable,
/obj/item/storage/bag/cash,
/turf/simulated/floor/warhammer/darkwood,
/area/map_template/wizard_station)
"bk" = (
/obj/structure/table/woodentable,
/obj/item/storage/candle_box,
/turf/simulated/floor/warhammer/darkwood,
/area/map_template/wizard_station)
"bl" = (
/obj/machinery/door/unpowered/simple/silver,
/turf/simulated/floor/warhammer/darkwood,
/area/map_template/wizard_station)
"bm" = (
/obj/item/device/radio/intercom/syndicate{
	dir = 1;
	pixel_y = -22
	},
/turf/simulated/floor/warhammer/darkwood,
/area/map_template/wizard_station)
"bn" = (
/obj/structure/closet/coffin,
/turf/simulated/floor/warhammer/darkwood,
/area/map_template/wizard_station)
"bp" = (
/obj/item/device/radio/intercom/syndicate{
	pixel_y = 22
	},
/turf/simulated/floor/warhammer/darkwood,
/area/map_template/wizard_station)
"bq" = (
/obj/structure/cult/pylon,
/turf/simulated/floor/warhammer/darkwood,
/area/map_template/wizard_station)
"br" = (
/obj/structure/kitchenspike,
/turf/simulated/floor/warhammer/darkwood,
/area/map_template/wizard_station)
"bs" = (
/obj/item/remains/human,
/turf/simulated/floor/warhammer/darkwood,
/area/map_template/wizard_station)
"bv" = (
/obj/structure/flora/ausbushes/fullgrass,
/turf/simulated/floor/warhammer/darkwood,
/area/map_template/wizard_station)
"bw" = (
/mob/living/simple_animal/hostile/creature{
	name = "Experiment 35b"
	},
/turf/simulated/floor/warhammer/darkwood,
/area/map_template/wizard_station)
"bx" = (
/obj/structure/cult/talisman,
/obj/item/material/knife/ritual,
/turf/simulated/floor/warhammer/darkwood,
/area/map_template/wizard_station)
"by" = (
/obj/gateway/active/cult,
/turf/simulated/floor/warhammer/coralg,
/area/map_template/wizard_station)
"bz" = (
/obj/structure/table/marble,
/obj/item/device/flashlight/slime,
/turf/simulated/floor/warhammer/darkwood,
/area/map_template/wizard_station)
"bA" = (
/mob/living/simple_animal/hostile/retaliate/goat{
	name = "Experiment 97d"
	},
/turf/simulated/floor/warhammer/darkwood,
/area/map_template/wizard_station)
"bB" = (
/obj/structure/flora/ausbushes/grassybush,
/turf/simulated/floor/warhammer/darkwood,
/area/map_template/wizard_station)
"bC" = (
/obj/structure/flora/pottedplant/unusual,
/turf/simulated/floor/warhammer/darkwood,
/area/map_template/wizard_station)
"bD" = (
/obj/structure/table/woodentable,
/obj/item/xenos_claw,
/turf/simulated/floor/warhammer/darkwood,
/area/map_template/wizard_station)
"bF" = (
/obj/overlay/palmtree_r,
/turf/simulated/floor/warhammer/darkwood,
/area/map_template/wizard_station)
"bG" = (
/mob/living/simple_animal/passive/crab{
	name = "Experiment 68a"
	},
/turf/simulated/floor/warhammer/darkwood,
/area/map_template/wizard_station)
"bH" = (
/obj/overlay/coconut,
/turf/simulated/floor/warhammer/darkwood,
/area/map_template/wizard_station)

(1,1,1) = {"
aa
aa
aa
aa
aa
aa
aa
aa
aa
aa
aa
aa
aa
aa
aa
aa
aa
aa
aa
aa
aa
aa
aa
aa
aa
aa
aa
aa
aa
aa
aa
aa
aa
aa
aa
aa
aa
"}
(2,1,1) = {"
aa
aa
aa
aa
aa
aa
aa
aa
aa
aa
aa
aa
aa
aa
aa
aa
aa
aa
aa
aa
aa
aa
aa
aa
aa
aa
aa
aa
aa
aa
aa
aa
aa
aa
aa
aa
aa
"}
(3,1,1) = {"
aa
aa
aa
aa
aa
aa
aa
aa
aa
aa
aa
aa
aa
aa
aa
aa
aa
aa
aa
aa
aa
aa
aa
aa
aa
aa
aa
aa
aa
aa
aa
aa
aa
aa
aa
aa
aa
"}
(4,1,1) = {"
aa
aa
aa
aa
aa
aa
aa
aa
aa
aa
aa
aa
aa
aa
aa
aa
aa
aa
aa
aa
aa
aa
aa
aa
aa
aa
aa
aa
aa
aa
aa
aa
aa
aa
aa
aa
aa
"}
(5,1,1) = {"
aa
aa
aa
aa
aa
aa
aa
aa
aa
aa
aa
aa
aa
aa
aa
aa
aa
aa
aa
aa
aa
aa
aa
aa
aa
aa
aa
aa
aa
aa
aa
aa
aa
aa
aa
aa
aa
"}
(6,1,1) = {"
aa
aa
aa
aa
aa
aa
aa
aa
aa
aa
aa
aa
aa
aa
aa
aa
aa
aa
aa
aa
aa
aa
aa
aa
aa
aa
aa
aa
aa
aa
aa
aa
aa
aa
aa
aa
aa
"}
(7,1,1) = {"
aa
aa
aa
aa
aa
aa
aa
aa
aa
aa
aa
aa
aa
aa
aa
aa
aa
aa
aa
aa
aa
aa
aa
aa
aa
aa
aa
aa
aa
aa
aa
aa
aa
aa
aa
aa
aa
"}
(8,1,1) = {"
aa
aa
aa
aa
aa
aa
aa
aa
aa
aa
aa
aa
aa
ab
ay
aM
aV
ab
aa
aa
aa
aa
aa
aa
aa
ab
ab
ab
ab
ab
aa
aa
aa
aa
aa
aa
aa
"}
(9,1,1) = {"
aa
aa
aa
aa
aa
aa
aa
aa
aa
aa
aa
aa
aa
ab
am
am
aW
ab
aa
aa
aa
aa
aa
aa
aa
ab
bs
am
am
ab
aa
aa
aa
aa
aa
aa
aa
"}
(10,1,1) = {"
aa
aa
aa
aa
aa
aa
aa
aa
aa
aa
aa
aa
aa
ab
aA
am
am
ab
aa
aa
aa
aa
aa
aa
aa
ab
am
am
am
ab
aa
aa
aa
aa
aa
aa
aa
"}
(11,1,1) = {"
aa
aa
aa
aa
aa
aa
aa
aa
aa
aa
aa
aa
aa
ab
aB
aN
aX
ab
aa
aa
aa
aa
aa
aa
aa
ab
am
bw
am
ab
aa
aa
aa
aa
aa
aa
aa
"}
(12,1,1) = {"
aa
aa
aa
aa
aa
aa
aa
aa
aa
aa
aa
aa
aa
ab
aC
am
aY
ab
aa
aa
aa
aa
aa
aa
aa
ab
am
am
bs
ab
aa
aa
aa
aa
aa
aa
aa
"}
(13,1,1) = {"
aa
aa
aa
aa
aa
aa
aa
aa
aa
aa
aa
aa
ab
ab
ab
aP
ab
ab
ab
aa
aa
aa
aa
aa
ab
ab
ay
aM
aV
ab
ab
aa
aa
aa
aa
aa
aa
"}
(14,1,1) = {"
aa
aa
aa
aa
aa
aa
aa
aa
aa
aa
aa
ab
ab
aw
aD
am
aZ
bg
ab
ab
aa
aa
aa
ab
ab
bq
am
bx
am
bq
ab
ab
aa
aa
aa
aa
aa
"}
(15,1,1) = {"
aa
aa
aa
aa
aa
aa
ab
ab
ab
ab
ab
ab
ar
am
am
am
am
am
bi
ab
ay
aM
aV
ab
bn
am
am
am
am
am
bC
ab
ab
ab
ab
ab
ab
"}
(16,1,1) = {"
aa
aa
aa
aa
aa
aa
ac
af
ai
al
ao
ab
as
am
aE
aQ
aE
am
bj
ab
am
am
bm
ab
am
am
ac
ab
ac
am
am
ac
am
am
am
bH
ab
"}
(17,1,1) = {"
aa
aa
aa
aa
aa
aa
ad
ag
aj
am
am
aq
am
am
aF
aR
ba
am
am
bl
am
am
am
bl
am
am
ad
by
ad
am
bD
ad
am
am
bG
am
ab
"}
(18,1,1) = {"
aa
aa
aa
aa
aa
aa
ae
ah
ak
an
ap
ab
au
ax
aG
aS
aG
am
bk
ab
am
am
am
ab
bp
am
ae
ab
ae
am
am
ae
am
bF
am
am
ab
"}
(19,1,1) = {"
aa
aa
aa
aa
aa
aa
ab
ab
ab
ab
ab
ab
av
am
am
am
am
am
bi
ab
ay
aM
aV
ab
bn
am
am
am
am
am
bC
ab
ab
ab
ab
ab
ab
"}
(20,1,1) = {"
aa
aa
aa
aa
aa
aa
aa
aa
aa
aa
aa
ab
ab
av
aH
am
bb
bh
ab
ab
aa
aa
aa
ab
ab
br
am
bz
am
br
ab
ab
aa
aa
aa
aa
aa
"}
(21,1,1) = {"
aa
aa
aa
aa
aa
aa
aa
aa
aa
aa
aa
aa
ab
ab
ab
aq
ab
ab
ab
aa
aa
aa
aa
aa
ab
ab
ay
aM
aV
ab
ab
aa
aa
aa
aa
aa
aa
"}
(22,1,1) = {"
aa
aa
aa
aa
aa
aa
aa
aa
aa
aa
aa
aa
aa
ab
aI
am
bc
ab
aa
aa
aa
aa
aa
aa
aa
ab
am
am
bB
ab
aa
aa
aa
aa
aa
aa
aa
"}
(23,1,1) = {"
aa
aa
aa
aa
aa
aa
aa
aa
aa
aa
aa
aa
aa
ab
aJ
am
bd
ab
aa
aa
aa
aa
aa
aa
aa
ab
am
am
am
ab
aa
aa
aa
aa
aa
aa
aa
"}
(24,1,1) = {"
aa
aa
aa
aa
aa
aa
aa
aa
aa
aa
aa
aa
aa
ab
aK
am
be
ab
aa
aa
aa
aa
aa
aa
aa
ab
am
bA
am
ab
aa
aa
aa
aa
aa
aa
aa
"}
(25,1,1) = {"
aa
aa
aa
aa
aa
aa
aa
aa
aa
aa
aa
aa
aa
ab
aL
am
bf
ab
aa
aa
aa
aa
aa
aa
aa
ab
bv
am
am
ab
aa
aa
aa
aa
aa
aa
aa
"}
(26,1,1) = {"
aa
aa
aa
aa
aa
aa
aa
aa
aa
aa
aa
aa
aa
ab
ay
aM
aV
ab
aa
aa
aa
aa
aa
aa
aa
ab
ab
ab
ab
ab
aa
aa
aa
aa
aa
aa
aa
"}
(27,1,1) = {"
aa
aa
aa
aa
aa
aa
aa
aa
aa
aa
aa
aa
aa
aa
aa
aa
aa
aa
aa
aa
aa
aa
aa
aa
aa
aa
aa
aa
aa
aa
aa
aa
aa
aa
aa
aa
aa
"}
(28,1,1) = {"
aa
aa
aa
aa
aa
aa
aa
aa
aa
aa
aa
aa
aa
aa
aa
aa
aa
aa
aa
aa
aa
aa
aa
aa
aa
aa
aa
aa
aa
aa
aa
aa
aa
aa
aa
aa
aa
"}
(29,1,1) = {"
aa
aa
aa
aa
aa
aa
aa
aa
aa
aa
aa
aa
aa
aa
aa
aa
aa
aa
aa
aa
aa
aa
aa
aa
aa
aa
aa
aa
aa
aa
aa
aa
aa
aa
aa
aa
aa
"}
(30,1,1) = {"
aa
aa
aa
aa
aa
aa
aa
aa
aa
aa
aa
aa
aa
aa
aa
aa
aa
aa
aa
aa
aa
aa
aa
aa
aa
aa
aa
aa
aa
aa
aa
aa
aa
aa
aa
aa
aa
"}
(31,1,1) = {"
aa
aa
aa
aa
aa
aa
aa
aa
aa
aa
aa
aa
aa
aa
aa
aa
aa
aa
aa
aa
aa
aa
aa
aa
aa
aa
aa
aa
aa
aa
aa
aa
aa
aa
aa
aa
aa
"}
(32,1,1) = {"
aa
aa
aa
aa
aa
aa
aa
aa
aa
aa
aa
aa
aa
aa
aa
aa
aa
aa
aa
aa
aa
aa
aa
aa
aa
aa
aa
aa
aa
aa
aa
aa
aa
aa
aa
aa
aa
"}
(33,1,1) = {"
aa
aa
aa
aa
aa
aa
aa
aa
aa
aa
aa
aa
aa
aa
aa
aa
aa
aa
aa
aa
aa
aa
aa
aa
aa
aa
aa
aa
aa
aa
aa
aa
aa
aa
aa
aa
aa
"}
