//MAP CONVERTED BY dmm2tgm.py THIS HEADER COMMENT PREVENTS RECONVERSION, DO NOT REMOVE
"b" = (
/obj/random/loot/valuableloot,
/turf/template_noop,
/area/template_noop)
"e" = (
/obj/random/loot/lightmelee,
/obj/random/loot/superrarearmor,
/turf/template_noop,
/area/template_noop)
"f" = (
/turf/template_noop,
/area/template_noop)

(1,1,1) = {"
b
f
f
"}
(2,1,1) = {"
f
e
f
"}
(3,1,1) = {"
f
f
f
"}
