//MAP CONVERTED BY dmm2tgm.py THIS HEADER COMMENT PREVENTS RECONVERSION, DO NOT REMOVE
"a" = (
/turf/template_noop,
/area/template_noop)
"b" = (
/turf/simulated/wall/sandstone/diamond,
/area/template_noop)
"c" = (
/turf/simulated/floor/fixed/alium,
/area/template_noop)
"e" = (
/obj/structure/fountain/strange,
/turf/template_noop,
/area/template_noop)
"W" = (
/obj/landmark/clear,
/turf/template_noop,
/area/template_noop)

(1,1,1) = {"
a
W
W
W
W
W
W
W
a
a
a
a
b
a
a
a
"}
(2,1,1) = {"
W
W
W
W
W
W
W
W
a
a
a
c
c
c
a
a
"}
(3,1,1) = {"
W
W
W
W
W
W
W
W
a
a
c
c
a
c
c
a
"}
(4,1,1) = {"
W
W
W
W
W
W
W
W
a
b
c
a
e
a
c
b
"}
(5,1,1) = {"
W
W
W
W
W
W
W
W
W
a
c
c
a
c
c
a
"}
(6,1,1) = {"
W
W
W
W
W
W
W
W
W
a
a
c
c
c
a
a
"}
(7,1,1) = {"
W
W
W
W
W
W
W
W
W
a
a
a
b
a
a
a
"}
(8,1,1) = {"
W
W
W
W
W
W
W
W
W
W
W
W
W
W
W
W
"}
(9,1,1) = {"
W
W
W
W
W
W
W
W
W
W
W
W
W
W
W
W
"}
(10,1,1) = {"
W
W
W
W
W
W
W
W
W
W
W
W
W
W
W
W
"}
(11,1,1) = {"
W
W
W
W
W
W
W
W
W
W
W
W
W
W
W
W
"}
(12,1,1) = {"
W
W
W
W
W
W
W
W
W
W
W
W
W
W
W
W
"}
(13,1,1) = {"
W
W
W
W
W
W
W
W
W
W
W
W
W
W
W
W
"}
(14,1,1) = {"
W
W
W
W
W
W
W
W
W
W
W
W
W
W
W
W
"}
(15,1,1) = {"
W
W
W
W
W
W
W
W
W
W
W
W
W
W
W
W
"}
(16,1,1) = {"
W
W
W
W
W
W
W
W
W
W
W
W
W
W
W
W
"}
