//MAP CONVERTED BY dmm2tgm.py THIS HEADER COMMENT PREVENTS RECONVERSION, DO NOT REMOVE
"a" = (
/turf/simulated/floor/exoplanet/water/shallow/tar,
/area/template_noop)
"b" = (
/turf/template_noop,
/area/template_noop)
"c" = (
/obj/structure/flora/ausbushes/lavendergrass,
/turf/template_noop,
/area/template_noop)
"d" = (
/obj/machinery/artifact,
/obj/landmark/clear,
/turf/simulated/floor/exoplanet/shrouded,
/area/template_noop)
"e" = (
/obj/structure/flora/ausbushes/fullgrass,
/turf/template_noop,
/area/template_noop)
"f" = (
/obj/structure/monolith,
/turf/simulated/floor/exoplanet/water/shallow/tar,
/area/template_noop)
"I" = (
/obj/structure/monolith{
	density = 0
	},
/turf/simulated/floor/exoplanet/water/shallow/tar,
/area/template_noop)
"K" = (
/obj/landmark/clear,
/obj/landmark/clear,
/turf/template_noop,
/area/template_noop)
"S" = (
/obj/landmark/clear,
/turf/template_noop,
/area/template_noop)

(1,1,1) = {"
S
S
S
S
S
a
b
b
b
b
b
a
a
a
e
b
"}
(2,1,1) = {"
S
S
S
S
S
b
b
c
a
a
f
a
a
a
a
b
"}
(3,1,1) = {"
S
S
S
S
S
b
b
a
a
a
a
a
a
a
a
a
"}
(4,1,1) = {"
S
S
S
S
S
b
a
a
a
a
a
a
a
a
a
a
"}
(5,1,1) = {"
S
S
S
S
S
c
a
a
a
a
a
a
a
a
a
b
"}
(6,1,1) = {"
S
S
S
S
S
a
f
a
a
a
d
a
a
a
f
b
"}
(7,1,1) = {"
S
S
S
S
S
a
a
a
a
a
a
a
a
a
a
c
"}
(8,1,1) = {"
S
S
S
S
S
a
a
a
a
a
a
a
a
a
a
b
"}
(9,1,1) = {"
S
S
S
S
S
b
a
a
a
a
a
a
a
a
c
b
"}
(10,1,1) = {"
S
S
S
S
S
b
b
c
a
a
I
a
a
b
a
b
"}
(11,1,1) = {"
S
S
S
S
S
b
a
b
b
b
a
b
b
b
b
b
"}
(12,1,1) = {"
K
K
K
K
K
S
S
S
S
S
S
S
S
S
S
S
"}
(13,1,1) = {"
K
K
K
K
K
S
S
S
S
S
S
S
S
S
S
S
"}
(14,1,1) = {"
K
K
K
K
K
S
S
S
S
S
S
S
S
S
S
S
"}
(15,1,1) = {"
K
K
K
K
K
S
S
S
S
S
S
S
S
S
S
S
"}
(16,1,1) = {"
K
K
K
K
K
S
S
S
S
S
S
S
S
S
S
S
"}
(17,1,1) = {"
K
K
K
K
K
S
S
S
S
S
S
S
S
S
S
S
"}
(18,1,1) = {"
K
K
K
K
K
S
S
S
S
S
S
S
S
S
S
S
"}
